####################################
#A        #       #       #       #
# ####### # ##### # ##### # ##### #
# #       # #     # #     # #     #
# # ##### # # ### # # ### # # ### #
# #     # #   #   #   #   #   #   #
# ##### # ##### ##### ##### ##### #
#       #       #       #       # #
####### ####### ####### ####### # #
#       #       #       #       # #
# ##### # ##### # ##### # ##### # #
# #     # #     # #     # #     # #
# # ### # # ### # # ### # # ### # #
#   #   #   #   #   #   #   #   # #
##### ##### ##### ##### ##### #####
#       #       #       #       # #
# ##### # ##### # ##### # ##### # #
# #     # #     # #     # #     # #
# # ### # # ### # # ### # # ### # #
#   #   #   #   #   #   #   #   # #
##### ##### ##### ##### ##### #####
#       #       #       #       # #
# ##### # ##### # ##### # ##### # #
# #     # #     # #     # #     # #
# # ### # # ### # # ### # # ### # #
#   #   #   #   #   #   #   #   # #
##### ##### ##### ##### ##### #####
#                                B#
####################################